####################
#S      #          #
#       #          #
#       #          #
#       #          #
#       #          #
#       #          #
#      E#          #
####################