#####################
#S  #   #   #   #   #
# # # # # # # # # # #
# # # # # # # # # # #
# # # # # # # # # # #
# #   #   #   #   # #
# ################# #
#                #E #
#####################
