####################
##                 #
## ############### #
## ############### #
## ############### #
##      ########## #
##S############### #
##     E           #
####################