##########
# #S# # ##
## # # # #
#E########
##########