#####################
#                   #
# ################# #
# ################# #
# ###################
#S                #E#
# ################# #
# #   #   #   #   # #
# # # # # # # # # # #
#   #   #   #   #   #
#####################