#####################
#                   #
# ################# #
# ################# #
#S                #E#
# ################# #
# ################# #
#                   #
#####################