####################
#                  #
#        #####     #
#        #   #     #
#         E  #     #
#    #########     #
#                  #
#    S             #
####################
