#####
#S  #
#   #
# E #
#####
