####################
#S                 #
#                  #
#                  #
#                  #
#                  #
#                  #
#                 E#
####################